....R...
....A.GY
....GY.A
...OB...
....O...
....B...
........
.R......