.R......
...Y..Y.
..B.....
........
...RA..G
...O...B
.A......
......OG