RBA.....
......O.
........
Y.YG....
........
G....B..
........
RO.A....